SSSSSSSSSSSSSSSSSSSSSSSSSSSSSSSSSSSSSSSSS
SSSSSSSSSSSSSSSSSSSSSSSSSSSSSSSSSSSSSSSSS
WWWWWWWWWWWWWWWWWWSSSSSSSSSSSSSSSSSSSSSSS
SSSSSSSSSSSSSSSSSSSSSSSSSSSSSSSSSSSSSSSSS
SSSSSSSSSSSSSSSSSSSSSSSSSSSSSSSSSSSSSSSSS
WWWWWWWWWWWWWWWWWWSSSSSSSSSWWWWWWWWWWWWWW
WWWWWWWWWWWWWWWWWWSSSSSSSSSWWWWWWWWWWWWWW
WWWWWWWWWWWWWWWWWWSSSSSSSSSWWWWWWWWWWWWWW
WWWWWWWWWWWWWWWWWWSSSSSSSSSWWWWWWWWWWWWWW
WWWWWWWWWWWWWWWWWWWWWWWWWWWWWWWWWWWWWWWWW