SSSSSSSSSSSSSSSSSSSSSSSSSSSSSSSSSSSSSSSSS
SSSSSSSSSSSSSSSSSSSSSSSSSSSSSSSSSSSSSSSSS
SSSSSSSSSSSSSSSSSSSSSSSSSSSSSSSSSSSSSSSSS
SSSSSSSWwSSSSSSSSSSSSSSSSSSSSSSSSSSSSSSSS
SSSSSSWWwSSSSSSSSSSSSSSSSSSSSSSSSSSSSSSSS
SSSSSWWWwSSSSSSSSSSSSSSSSSSSSSSSSSSSSSSSS
SSSSWWWwWSSSSSSWWSSSSSSSSSSSSSSSSSSSSSSSS
WWWWWWWWWWWWWWWWWWWWWWWWWWWWWWWWWWWWWWWWW
WWWWWWWWWWWWWWWWWWWWWWWWWWWWWWWWWWWWWWWWW
WWWWWWWWWWWWWWWWWWWWWWWWWWWWWWWWWWWWWWWWW